############################
#A            #   #        #
# ########### # # # ###### #
#     #     # # # #      # #
##### # ### # # # ###### # #
#   # # # # # # #      # # #
# # # # # # # # ###### # # #
# # # # # # # #      # # # #
# # # # # # # ###### # # # #
# # # # # #          # # # #
# # # # # ############ # # #
# # # # #              # # #
# # # # ################ # #
# # # #                  # #
# # # ############## ### # #
# # #              # #   # #
# # ############## # # ### #
# #                # # #   #
# ################ # # # # #
#                  # # # # #
################## # # # # #
#        #         # # # # #
# ###### ######### # # # # #
#      #         # # # # # #
###### ######### # # # # # #
#    #           # # # # # #
# ## ############# # # # # #
# #  #             # # # # #
# # ## ########### # # # # #
# # #  #           # # # # #
# # # ###############B# # #
# # #                 # # #
# # ################### # #
# #                     # #
############################